"a" = (/turf/unsimulated/grass,/area)

(1,1,1) = {"
a
"}
