"a" = (/turf/unsimulated/asteroid_sand,/area)

(1,1,1) = {"
aaa
aaa
aaa
"}
